You are an ordinary clown fish with an orange body and white stripes. You live in a coral reef with your brother Omen.

Your brother Omen has gone missing! You last saw him going for a stroll by your house.

Find Omen.

Finding Omen
An Interactive Fiction by Jaryd Ma
Release 1 / Serial number 141003 / Inform 7 build 6L38 (I6/v6.33 lib 6/12N) SD

Your Home
Home sweet Home. Protected by a sea anemone, one of the few places that you feel safe in. The only thing here is some seaweed.

School is east

>hint
test

* * *

You are an ordinary clown fish with an orange body and white stripes. You live in a coral reef with your brother Omen.

Your brother Omen has gone missing! You last saw him going for a stroll by your house.

Find Omen.

Finding Omen
An Interactive Fiction by Jaryd Ma
Release 1 / Serial number 141003 / Inform 7 build 6L38 (I6/v6.33 lib 6/12N) SD

Your Home
Home sweet Home. Protected by a sea anemone, one of the few places that you feel safe in. The only thing here is some seaweed.

School is east

>w
You can't go that way.

>e
School
an empty classroom with only a teacher becuase school has ended. A forgotten lunchbox is in the corner.

You can see Teacher Jon here.

>s
Ship Wreckage
You can see Bob here.

>talk to bob
That's not a verb I recognise.

>x bob
a HUNGRY great white shark, you better have good reason to talk to him.

* * *

You are an ordinary clown fish with an orange body and white stripes. You live in a coral reef with your brother Omen.

Your brother Omen has gone missing! You last saw him going for a stroll by your house.

Find Omen.

Finding Omen
An Interactive Fiction by Jaryd Ma
Release 1 / Serial number 141003 / Inform 7 build 6L38 (I6/v6.33 lib 6/12N) SD

Your Home
Home sweet Home. Protected by a sea anemone, one of the few places that you feel safe in. The only thing here is some seaweed.

School is east

>e
School
an empty classroom with only a teacher becuase school has ended. A forgotten lunchbox is in the corner.

your home is west, the ship wreckage is south

You can see Teacher Jon here.

>open box
You can't see any such thing.

>x lunch box
You can't see any such thing.

>xbox
That's not a verb I recognise.

>x box
You can't see any such thing.

>x lunchbox
an old tin box with Sponge Bob on it.

>open it
You open Lunchbox, revealing Sandwich.

* * *

>e
School
an empty classroom with only a teacher becuase school has ended. A forgotten lunchbox is in the corner.

your home is west, the ship wreckage is south

You can see Teacher Jon here.

>x lunchbox
an old tin box with Sponge Bob on it.

>open box
You open medical box, revealing nothing.

* * *

>e
School
an empty classroom with only a teacher becuase school has ended. A forgotten lunchbox is in the corner.

your home is west, the ship wreckage is south

You can see Teacher Jon here.

>w
Your Home
protected by a sea anemone, the only thing here is some seaweed.

School is east

>e
School
an empty classroom with only a teacher becuase school has ended. A forgotten lunchbox is in the corner.

your home is west, the ship wreckage is south

You can see Teacher Jon here.

>s
Ship Wreckage
An old wooden ship lies here and is covered with marine life, it has become one with nature. An great white shark named Bob is swimming around.

You can see Bob here.

* * *

>e
School
an empty classroom with only a teacher becuase school has ended. A forgotten lunchbox is in the corner.

your home is west, the ship wreckage is south

You can see Teacher Jon here.

>s
Ship Wreckage
An old wooden ship lies here and is covered with marine life, it has become one with nature. An great white shark named Bob is swimming around.

Jellyfish fields is east, school is north

You can see Bob here.

>e
Jellyfish Fields
A endless group of giant jelly fish bob up and down, Mr Jelly is the leader.

A small blue fish name Annie is swimming in circles.

Ship wreckage is west, seaweed forest is south

You can see Annie here.

>s
Seaweed Forest

>n
Jellyfish Fields

>w
Ship Wreckage

* * *

>e
Jellyfish Fields
A endless group of giant jelly fish bob up and down, Mr Jelly is the leader.

A small blue fish name Annie is swimming in circles.

Ship wreckage is west, seaweed forest is south

You can see Annie here.

>w
Ship Wreckage
An old wooden ship lies here and is covered with marine life, it has become one with nature. An great white shark named Bob is swimming around.

Jellyfish fields is east, school is north

You can see Bob here.

>n
School
an empty classroom with only a teacher becuase school has ended. A forgotten lunchbox is in the corner.

your home is west, the ship wreckage is south

You can see Teacher Jon here.

>e
You can't go that way.

>s
Ship Wreckage
An old wooden ship lies here and is covered with marine life, it has become one with nature. An great white shark named Bob is swimming around.

Jellyfish fields is east, school is north

You can see Bob here.

* * *

>e
Jellyfish Fields
A endless group of giant jelly fish bob up and down, Mr Jelly is the leader.

A small blue fish name Annie is swimming in circles.

Ship wreckage is west, seaweed forest is south

You can see Annie here.

>s
Seaweed Forest
a dense forest on seaweed lies in front of you. Mysterious and dangerous looking, you were told as a child to not go near here.

Jellyfish fields is north

* * *

>s
Ship Wreckage
An old wooden ship lies here and is covered with marine life, it has become one with nature. An great white shark named Bob is swimming around.

Jellyfish fields is east, school is north

You can see Bob here.

>talk to bob
That's not a verb I recognise.

>ask bob about food
ID.

* * *

>e
School
an empty classroom with only a teacher becuase school has ended. A forgotten lunchbox is in the corner.

your home is west, the ship wreckage is south

You can see Teacher Jon here.

>take all
There are none at all available!

>x lunch box
You can't see any such thing.

>x lunchbox
an old tin box with Sponge Bob on it.

>open it
You open Lunchbox, revealing a sandwich.

>takeit
That's not a verb I recognise.

>take it
Taken.

>talk to teacher jon
That's not a verb I recognise.

>x jon
Just an ordinary teacher, combed hair and a a collared shirt.

>s
Ship Wreckage
An old wooden ship lies here and is covered with marine life, it has become one with nature. An great white shark named Bob is swimming around.

You can see Bob here.

>talk to bob
That's not a verb I recognise.

* * *

>x bob
a HUNGRY great white shark, you better have good reason to talk to him.

>e
Jellyfish Fields
A endless group of giant jelly fish bob up and down, Mr Jelly is the leader.

A small blue fish name Annie is swimming in circles.

You can see Annie here.

>x mr jelly
just relaxing in the water, taking a nap.

>x annie
A small blue fish with a yellow dorsil fin.

>ask annie about omen
Yes! I've seen him. umm... I think he was by the ...... no, he was by the .....

ugggg. I can't remember anything, if you find a memory pill to help me out, I can denfinetly help you.

>s
Seaweed Forest
a dense forest on seaweed lies in front of you. Mysterious and dangerous looking, you were told as a child to not go near here.

>n
Jellyfish Fields
A endless group of giant jelly fish bob up and down, Mr Jelly is the leader.

A small blue fish name Annie is swimming in circles.

You can see Annie here.

>w
Ship Wreckage
An old wooden ship lies here and is covered with marine life, it has become one with nature. An great white shark named Bob is swimming around.

You can see Bob here.

>ask bob about memory pill
I may have one on me, but I'm too hungry to remember!!!!

>give bob sandwich
(first taking the sandwich)
You hand the sandwich to Bob and he immidiatly devours it.

"thanks for the food, I was thinking about eating you. I think this will help you out, I found a box filled with medical stuff. Here, take it.

>x box
You can't see any such thing.

>x kit
a rusty metal box with a red plus sign on it.

>open it
You open medical kit, revealing memory pill.

>take it
You already have that.

>take pill
Taken.

>n
School
an empty classroom with only a teacher becuase school has ended. A forgotten lunchbox is in the corner.

You can see Teacher Jon here.

>ask jon about pill
There is no reply.

>ask jon about memory pill
Memory pill?? Is that even a thing?? Never heard of it, I only teach 3rd grade math.

>ask jon about omen
Sorry I haven't seen him since school ended, might want to try someone else.

>e
You can't go that way.

>s
Ship Wreckage
An old wooden ship lies here and is covered with marine life, it has become one with nature. An great white shark named Bob is swimming around.

You can see Bob here.

>ask bob about omen
I'm hungry give me food before I eat you!

>give bob sandwich
You can't see any such thing.

>i
You are carrying:
  memory pill
  medical kit (open but empty)
  Lunchbox (open but empty)

>s
You can't go that way.

>e
Jellyfish Fields
A endless group of giant jelly fish bob up and down, Mr Jelly is the leader.

A small blue fish name Annie is swimming in circles.

You can see Annie here.

>give annie memory pill
You hand the pill to Annie and hope for the best.

>give mr jelly memory pill
You can only do that to something animate.

>give memory pill to annie
You hand the pill to Annie and hope for the best.

I beg your pardon?

* * *

>e
School
an empty classroom with only a teacher becuase school has ended. A forgotten lunchbox is in the corner.

your home is west, the ship wreckage is south

You can see Teacher Jon here.

>x box
You can't see any such thing.

* * *

>open it
You open Lunchbox, revealing a sandwich.

>take it
Taken.

>s
Ship Wreckage
An old wooden ship lies here and is covered with marine life, it has become one with nature. An great white shark named Bob is swimming around.

You can see Bob here.

>give bob sandwich
(first taking the sandwich)
You hand the sandwich to Bob and he immidiatly devours it.

"thanks for the food, I was thinking about eating you. I think this will help you out, I found a box filled with medical stuff. Here, take it.

>open kti
You can't see any such thing.

>open kit
You open medical kit, revealing memory pill.

>take it
You already have that.

>s
You can't go that way.

* * *

>e
Jellyfish Fields
A endless group of giant jelly fish bob up and down, Mr Jelly is the leader.

A small blue fish name Annie is swimming in circles.

You can see Annie here.

>give annie memory pill
(first taking memory pill)
You hand the pill to Annie and hope for the best.

Annie swallows the pill and starts to pass out. She immidiaty wakes up and tells you that she heard a voice from the seaweed forest. You swim there as fast as you can to find Omen tangled in the seaweed. He is relieved to see you and says "what took you so long?"

    *** You Win ***

Would you like to RESTART, RESTORE a saved game, QUIT or UNDO the last command?

* * *

You are an ordinary clown fish with an orange body and white stripes. You live in a coral reef with your brother Omen.

Your brother Omen has gone missing! You last saw him going for a stroll by your house.

Find Omen.

Finding Omen
An Interactive Fiction by Jaryd Ma
Release 1 / Serial number 141003 / Inform 7 build 6L38 (I6/v6.33 lib 6/12N) SD

Your Home
Home sweet Home. Protected by a sea anemone, one of the few places that you feel safe in. The only thing here is some seaweed.

School is east

>x player
You can't see any such thing.

* * *

You are an ordinary clown fish with an orange body and white stripes. You live in a coral reef with your brother Omen.

Your brother Omen has gone missing! You last saw him going for a stroll by your house.

Find Omen.

Finding Omen
An Interactive Fiction by Jaryd Ma
Release 1 / Serial number 141003 / Inform 7 build 6L38 (I6/v6.33 lib 6/12N) SD

Your Home
Home sweet Home. Protected by a sea anemone, one of the few places that you feel safe in. The only thing here is some seaweed.

School is east

>s
You can't go that way.

>w
You can't go that way.

>e
School

>x lunchbox
You see nothing special about Lunchbox.

>open lunchbox
You open Lunchbox.

>take box
You can't see any such thing.

>take luchbox
You can't see any such thing.

* * *

You are an ordinary clown fish with an orange body and white stripes. You live in a coral reef with your brother Omen.

Your brother Omen has gone missing! You last saw him going for a stroll by your house.

Find Omen.

Finding Omen
An Interactive Fiction by Jaryd Ma
Release 1 / Serial number 141003 / Inform 7 build 6L38 (I6/v6.33 lib 6/12N) SD

Your Home
Home sweet Home. Protected by a sea anemone, one of the few places that you feel safe in. The only thing here is some seaweed.

School is east

>x seaweed
green, smelly and salty.

>take seaweed
That's hardly portable.

>s
You can't go that way.

>n
You can't go that way.

>w
You can't go that way.

* * *

>e
School
an empty classroom with only a teacher becuase school has ended. A forgotten lunchbox is in the corner.

You can see Teacher Jon here.

>take teacher jon
I don't suppose Teacher Jon would care for that.

>talk to jon
That's not a verb I recognise.

>x lunchbox
an old tin box with Sponge Bob on it.

* * *

>open it
You open Lunchbox, revealing a sandwich.

>take sandwich
Taken.

>x it
a yummy ham and cheese sandwich on white bread with the crust cut off.

>s
Ship Wreckage
You can see Bob here.

* * *

>talk to bob
That's not a verb I recognise.

>s
You can't go that way.

>e
Jellyfish Fields
You can see Annie here.

>talk to annie
That's not a verb I recognise.

>x annie
A small blue fish with a yellow dorsil fin.

>s
Seaweed Forest

>take all
(the sandwich)
You already have that.

>x omen
Your brother! an orange clown fish, a mirror image of you.

>x seaweed
You can't see any such thing.